8
9
Loop:	False
Magnet:	True

0	1	1	1	1	1	1	0
0	4	4	4	4	4	4	0
1	4	4	4	4	4	4	1
1	2	2	2	3	3	3	1
1	2	2	2	3	3	3	1
1	2	2	2	3	3	3	1
1	5	5	5	5	5	5	1
0	5	5	5	5	5	5	0
0	1	1	1	1	1	1	0