8
8
Loop:	True
Magnet:	False

0	0	1	1	3	3	3	5
0	1	1	1	4	0	0	5
1	1	1	1	4	2	0	5
1	1	1	1	1	4	2	2
5	2	2	1	1	1	1	1
5	0	4	2	1	1	1	1
5	0	0	4	1	1	1	0
3	3	3	4	1	1	0	0