8
8
Loop:	False
Magnet:	True

1	1	0	0	0	0	0	0
1	1	0	0	0	0	0	0
0	0	1	1	1	1	0	0
0	0	1	1	1	1	0	0
0	0	1	1	1	1	0	0
0	0	1	1	1	1	0	0
0	0	0	0	0	0	1	1
0	0	0	0	0	0	1	1