9
9
Loop:	False
Magnet:	False

3	3	3	3	3	3	3	3	5
4	1	1	1	1	1	1	1	5
4	0	1	1	1	1	1	0	5
4	0	0	1	1	1	0	0	5
4	0	1	0	1	0	1	0	5
4	0	1	1	0	1	1	0	5
4	0	1	1	1	1	1	0	5
4	1	1	1	1	1	1	1	5
4	2	2	2	2	2	2	2	2
