8
8
Loop:	False
Magnet:	True

9	9	9	9	9	9	9	9
9	9	9	9	9	9	9	9
9	9	9	9	9	9	9	9
9	9	9	9	9	9	9	9
9	9	9	9	9	9	9	9
9	9	9	9	9	9	9	9
3	3	3	3	3	3	3	4
0	0	0	0	0	0	0	0