8
10
Loop:	False
Magnet:	True

4	4	0	0	0	0	0	0
4	4	1	0	0	0	0	0
4	4	4	1	0	0	0	0
4	4	4	4	1	0	0	0
4	4	4	4	4	1	0	0
4	4	4	4	4	4	1	0
4	4	4	4	4	4	4	1
4	4	4	0	0	0	0	0
4	4	4	0	0	0	0	0
4	4	4	0	0	0	0	0

