8
8
Loop:	False
Magnet:	True

5	5	5	0	0	5	5	5
5	5	5	0	0	5	5	5
5	5	5	0	0	5	5	5
5	5	5	0	0	5	5	5
5	5	5	0	0	5	5	5
9	9	9	5	5	8	8	8
3	9	9	5	5	8	8	2
0	3	3	1	1	2	2	0