9
9
Loop:	False
Magnet:	True

3	3	3	3	3	1	0	0	1
3	3	3	3	1	0	0	1	2
3	3	3	1	0	0	1	2	2
3	3	1	0	0	1	2	2	2
3	1	0	0	1	2	2	2	2
1	0	0	1	2	2	2	2	2
0	0	1	2	2	2	2	2	2
0	1	2	2	2	2	2	2	2
1	2	2	2	2	2	2	2	2
