9
9
Loop:	False
Magnet:	True

9	9	5	0	5	0	5	8	8
9	9	5	0	5	0	5	8	8
3	3	1	0	5	0	1	2	2
0	0	0	0	1	0	0	0	0
3	3	3	1	0	1	2	2	2
0	0	0	0	1	0	0	0	0
3	3	1	0	4	0	1	2	2
7	7	4	0	4	0	4	6	6
7	7	4	0	4	0	4	6	6