8
8
Loop:	False
Magnet:	False

5	2	2	2	2	2	2	2
3	3	3	3	3	3	3	4
0	0	0	0	0	0	0	0
1	1	1	1	1	1	1	1
1	1	1	1	1	1	1	1
1	1	1	1	1	1	1	1
1	1	1	1	1	1	1	1
1	1	1	1	1	1	1	1