9
10
Loop:	False
Magnet:	True

0	3	9	9	5	8	8	2	0
0	0	3	9	5	8	2	0	0
0	0	0	3	5	2	0	0	0
0	0	0	0	5	0	0	0	0
0	0	0	0	5	0	0	0	0
0	0	0	9	5	8	0	0	0
0	0	9	9	5	8	8	0	0
0	9	9	9	5	8	8	8	0
9	9	9	9	5	8	8	8	8
9	9	9	9	5	8	8	8	8