7
7
Loop:	True
Magnet:	False

0	1	1	1	1	1	0
1	1	0	1	0	1	1
1	0	1	1	1	0	1
1	1	1	0	1	1	1
1	0	1	1	1	0	1
1	1	0	1	0	1	1
0	1	1	1	1	1	0
