9
9
Loop:	False
Magnet:	True

0	0	5	5	5	5	5	0	0
0	9	9	5	5	5	8	8	0
9	9	1	1	1	1	1	8	8
3	3	1	0	0	0	1	2	2
3	3	1	0	0	0	1	2	2
3	3	1	0	0	0	1	2	2
7	7	1	1	1	1	1	6	6
0	7	7	4	4	4	6	6	0
0	0	7	4	4	4	6	0	0