8
8
Loop:	True
Magnet:	True

5	2	2	2	2	2	2	2
5	5	2	2	2	2	2	4
5	5	0	0	0	0	4	4
5	5	0	0	0	0	4	4
5	5	0	0	0	0	4	4
5	5	0	0	0	0	4	4
5	3	3	3	3	3	4	4
3	3	3	3	3	3	3	4