7
6
Loop:	False
Magnet:	True

0	1	1	1	1	1	0
0	1	1	1	1	1	0
0	1	1	0	1	1	0
0	1	1	1	1	1	0
0	1	1	1	1	1	0
0	0	0	0	0	0	0
