8
10
Loop:	False
Magnet:	True

5	2	2	2	2	2	2	2
5	5	2	2	2	2	2	2
5	5	5	2	2	2	2	2
5	5	5	0	0	0	0	0
5	5	5	0	0	0	0	0
5	5	5	0	0	0	0	0
5	5	5	0	0	0	0	0
5	5	3	3	3	3	3	3
5	3	3	3	3	3	3	3
3	5	3	3	3	3	3	3