8
8
Loop:	True
Magnet:	True

0	0	1	1	0	0	0	0
0	1	1	1	1	0	0	0
1	1	1	1	1	1	0	0
1	1	1	1	1	1	1	0
0	1	1	1	1	1	1	1
0	0	1	1	1	1	1	1
0	0	0	1	1	1	1	0
0	0	0	0	1	1	0	0