9
10
Loop:	False
Magnet:	True

0	0	0	0	0	0	0	0	5
0	0	0	0	0	0	0	5	8
0	0	0	0	0	0	5	8	8
0	0	0	0	0	5	8	8	8
0	0	0	0	5	8	8	8	8
0	0	0	5	8	8	8	8	8
0	0	5	8	8	8	8	8	8
0	5	8	8	8	8	8	8	8
5	8	8	8	8	8	8	8	8
5	8	8	8	8	8	8	8	8

