9
9
Loop:	True
Magnet:	False

3	3	3	3	3	3	3	3	5
4	0	0	0	0	0	0	0	5
4	0	5	2	2	2	2	0	5
4	0	5	0	0	0	4	0	5
4	0	5	0	0	0	4	0	5
4	0	5	0	0	0	4	0	5
4	0	3	3	3	3	4	0	5
4	0	0	0	0	0	0	0	5
4	2	2	2	2	2	2	2	2

