8
8
Loop:	False
Magnet:	True

0	0	0	5	0	0	0	0
0	0	5	5	5	0	0	0
0	5	5	5	5	5	0	0
5	5	5	5	5	5	5	0
5	5	5	5	5	5	5	0
5	5	5	5	5	5	5	0
5	5	5	5	5	5	5	0
1	1	1	1	1	1	1	0