8
7
Loop:	False
Magnet:	True

3	3	3	3	3	3	1	0
0	3	3	3	3	3	1	0
0	0	3	3	3	3	1	0
0	0	0	3	3	3	1	0
0	0	3	3	3	3	1	0
0	3	3	3	3	3	1	0
3	3	3	3	3	3	1	0
