9
9
Loop:	False
Magnet:	True

5	5	5	0	0	0	1	2	2
5	5	5	0	0	0	1	2	2
1	1	1	0	0	0	1	2	2
0	0	0	1	1	1	0	0	0
0	0	0	1	0	1	0	0	0
0	0	0	1	1	1	0	0	0
3	3	1	0	0	0	1	1	1
3	3	1	0	0	0	4	4	4
3	3	1	0	0	0	4	4	4