8
8
Loop:	False
Magnet:	True

3	3	3	3	3	3	3	5
0	0	0	0	0	0	0	5
3	3	3	3	3	5	0	5
4	0	3	1	1	5	0	5
4	0	4	1	1	5	0	5
4	0	4	2	2	2	0	5
4	0	0	0	0	0	0	5
4	2	2	2	2	2	2	2