8
8
Loop:	False
Magnet:	True

0	9	9	5	5	8	8	0
0	9	9	5	5	8	8	0
0	9	9	5	5	8	8	0
9	9	9	5	5	8	8	8
3	9	9	5	5	8	8	2
0	3	9	5	5	8	2	0
0	0	3	5	5	2	0	0
0	0	0	1	1	0	0	0