9
9
Loop:	False
Magnet:	False

3	3	3	3	3	3	3	3	5
4	3	3	3	3	3	3	5	5
4	4	3	3	3	3	5	5	5
4	4	4	3	3	5	5	5	5
4	4	4	1	0	5	5	5	5
4	4	4	4	2	2	5	5	5
4	4	4	2	2	2	2	5	5
4	4	2	2	2	2	2	2	5
4	2	2	2	2	2	2	2	2
