9
6
Loop:	True
Magnet:	True

1	1	1	1	1	1	1	1	1
1	5	2	2	2	2	2	2	1
1	5	1	1	1	1	1	4	1
1	5	1	1	1	1	1	4	1
1	3	3	3	3	3	3	4	1
1	1	1	1	1	1	1	1	1